
NO ./textures/wall0.xpm
SO ./textures/wall1.xpm
WE ./textures/wall2.xpm
EA ./textures/wall3.xpm


F 184,113,39
C 51,198,227
11111111
10000001
10000S01
11111111             