R 848 480
NO textures/sky_1.xpm
SO textures/sky_1.xpm
WE textures/sky_1.xpm
EA textures/sky_1.xpm
S textures/sprite_1.xpm
SC textures/sprite_3.xpm
F 184,113,39
C 51,198,227
x x x x x x x x x x x x x x x x x x x x 1 1 1 1 1 1 x x x x x x x x x x x x x x                           
x x x x x x x x x x x x x x x x x x x 1 0 0 0 0 0 0 1 0 0 1 1 1 x x x x x x x x
x x x x x x 1 1 1 1 x x x x x x x x x 1 0 0 0 0 0 0 0 0 1 0 1 0 0 1 x x x x x x
x x x x x 1 0 0 0 1 1 1 1 1 1 1 1 1 0 0 0 0 0 0 0 0 0 0 1 1 0 0 0 1 x x x x x x
x x x x	1 0 0 0 0 0 0 0 0 0 0 0 0 0 0 0 0 0 0 0 0 0 0 0 0 0 0 0 0 1 x x x x x x
x x x x	1 0 0 0 0 0 0 0 0 0 0 0 0 0 0 0 0 0 0 0 0 0 0 0 0 0 0 0 0 1 x x x x x x
x x x x	1 0 0 0 0 1 1 1 1 1 0 0 1 1 0 0 0 0 0 S 0 0 0 0 1 1 0 0 0 1 x x x x x x
x x x 1 1 0 0 0 0 1 x x 1 0 0 0 0 1 0 0 0 0 0 0 0 0 0 0 1 x 1 0 0 1 x x x 1 1 x    									    
x x 1 0 1 1 0 0 1 1 x x 1 0 0 0 0 0 1 0 0 0 0 0 0 0 0 1 1 1 1 0 0 1 1 1 1 0 0 1
x 1 0 0 0 1 0 0 1 x 1 1 1 0 0 0 0 0 0 1 1 1 0 0 1 1 1 1 0 0 0 0 0 0 0 0 0 0 0 1
1 0 0 0 0 1 0 0 1 1 0 0 1 0 0 0 0 0 0 1 x 1 0 0 1 x 1 0 0 0 0 0 0 0 0 0 0 0 0 1
1 0 0 0 0 0 0 0 0 0 0 0 1 0 0 0 0 0 0 1 x 1 0 0 1 x 1 0 0 0 1 0 0 1 1 1 1 0 0 1
1 0 0 0 0 0 0 0 0 0 0 0 1 0 0 0 0 0 0 1 x 1 0 0 1 x 1 1 1 1 1 0 0 1 x x 1 0 0 1
1 0 0 0 0 1 0 0 1 1 0 0 1 1 1 1 1 1 1 1 x 1 0 0 1 1 1 1 1 1 1 0 0 1 x x x 1 1 x
x 1 0 0 0 1 0 0 0 1 0 0 1 1 0 0 0 0 0 1 x 1 0 0 0 0 0 0 0 1 1 0 0 1 x x x x x x
x x 1 0 1 1 0 0 0 1 1 1 1 1 0 0 0 0 0 1 x 1 0 0 0 0 0 0 0 1 1 0 0 1 x x x x x x
x x x 1 1 0 0 0 0 1 x x x 1 0 0 0 0 1 x x 1 0 0 1 0 0 0 0 1 1 0 0 1 1 1 x x x x
x x x x 1 0 0 0 0 1 1 1 1 1 0 0 0 1 x 1 1 1 0 0 1 0 0 0 0 1 0 0 0 0 0 1 x x x x
x x x x 1 0 0 0 0 0 0 0 0 1 0 0 0 1 1 0 0 0 0 0 1 1 1 1 1 0 0 0 0 0 0 1 x x x x
x x x x 1 0 0 0 0 0 0 0 0 1 0 0 0 1 0 0 0 0 0 0 0 0 0 0 0 0 0 0 0 0 0 1 x x x x
x x x x x 1 0 0 0 1 1 0 0 1 0 0 1 1 0 0 0 0 0 0 0 0 0 0 0 0 0 0 0 0 1 x x x x x
x x x x x x 1 1 1 1 1 0 0 1 0 0 1 1 0 0 0 0 0 0 1 1 0 0 1 1 0 0 0 1 x x x x x x
x x x x x x x x x x 1 0 0 0 0 0 0 0 0 0 0 0 0 0 1 0 0 0 0 1 0 0 1 x x x x x x x
x x x x x x x x x x 1 0 0 0 0 0 0 0 0 0 0 0 0 0 1 0 0 0 0 1 1 1 x x x x x x x x
x x x x x x x x x x	1 1 1 1 1 1 1 1 0 0 0 0 0 0 1 1 0 0 1 x x x x x x x x x x x 
x x x x x x x x x x x x x x x x x x 1 0 0 0 0 1 1 x 1 1 x x x x x x x x x x x x
x x x x x x x x x x x x x x x x x x x 1 1 1 1 x x x x x x x x x x x x x x x x x