R 848 480
NO textures/sky_1.xpm
SO textures/sky_1.xpm
WE textures/sky_1.xpm
EA textures/sky_1.xpm
S textures/sprite_1.xpm
SC textures/sprite_3.xpm
F 184,113,39
C 51,198,227
                    111111              
                   10000001  111        
       1111       1000000001 1001        
     10001111111110000000000110001      
    100000000000000000000000000001      
    100000000000000000000000000001      
    1000011111001100000S0000110001      
   1100001  10000100000000001 1001   11  
  10110011  1000001000000001111001111001 
 10001001 111000000111001111000000000001 
10000100110010000001 1001 10000000000001
10000000000010000001 1001 10001001111001
10000000000010000001 1001 11111001  1001
10000100110011111111 1001111111001   11 
 1000100010011000001 1000000011001      
  101100011111000001 1000000011001      
   1100001   100001  100100001100111    
    10000111110001 11100100001000001    
    10000000010001100000111110000001    
    10000000010001000000000000000001    
     100011001001100000000000000001     
      1111100100110000001100110001      
          10000000000000100001001       
          1000000000000010000111        
          1111111100000011001           
                  1000011 11            
                   1111                 