
NO textures/sky_1.xpm
SO textures/sky_2.xpm
WE textures/sky_3.xpm
EA textures/sky_4.xpm

AM 22,4
AM 38,10
AM 26,15
AM 23,23
AM 11,12

CP 11,11

D 12,8
D 12,5

F 184,113,39
C 51,198,227
                    111111              
                   10000001  111        
      11111       1000000001 1001       
     10001111111110000000000110001      
    100000000000000000010000000001      
    100000000000000000000000000001      
    100001111100110000000000110001      
   1100001  10000100000000001 1001   11 
  10110011  1000011000000001111001111001
 10001001 111000001111001111000000000001
10000100110010000001 1001 10000000000001
10000100100010000001 1001 10001001111001
10E00000000010000001 1001 11111001  1001
10000100110011111111 1001111111001   11 
 1000100110011000001 1000000011001      
  101100111111000001 1001000011001      
   1100001   100001  100100001100111    
    10000111110001 11100100001000001    
    10000000010001100000111111000001    
    10000000010001000000000000000001    
     100011001001100000000000000001     
      1111100101110000001100110001      
          10000000000000100001001       
          1000000000000010000111        
          1111111100000011001           
                  1000011 11            
                   1111                 