
NO textures/sky_1.xpm
SO textures/sky_2.xpm
WE textures/sky_3.xpm
EA textures/sky_4.xpm


F 184,113,39
C 51,198,227
 1111111
 1000001
 100S001
 1000001
 1111111             